R     1500        12000

NO    ./imgs/serj.xpm
SO ./imgs/daron.xpm
WE ./imgs/shavo.xpm
EA  ./imgs/john.xpm

S ./imgs/sprite.xpm
F 0,0,0
C       255,255,255



1111111111111111111111111111111
100000000000000000000001 
100000000000000000000001
100000000000000000000001
100000111110000202020001
100000100010000000000001
100000100010000000000001
100000100010000000000001
100000110110000000000001
100000000000001110000001
100000000000001010000001
100000000000001110000001
100000011111111111111111
100000000000000000000001
100000011111111111111111
100000000022222222200001
111111111000000000000001
110100021200000002000001
110000221200000000000001
110100001200000000N00001
110111111200000000000001
110222222000000000000001
111111111000000000000221
111111111111111111111111