R 5000 4000
NO         ./imgs/1.xpm
SO ./imgs/1.xpm
WE ./imgs/1.xpm
EA ./imgs/1.xpm
S ./imgs/sprite.xpm
F 220,100,0
C 225,30,0

111111111111111111111111
100000000000000000000001
100000000000000000000001
100000000000000000000001
100000111110000202020001
100000100010000000000001
100000100010000200020001
100000100010000000000001
100000110110000000000001
100000000000001110000001
100000000000001010000001
100000000000001110000001
100000011111111111111111
100000000000000000000001
100000011111111111111111
100000000000000000000001
111111111000000000000001
110100001000000002000001
110000201000000000000001
110100001000000000000001
110111111000000000W00001
110000000000000000000001
111111111000000000000001
111111111111111111111111