R 800 400

NO            ./imgs/serj.xpm
SO ./imgs/daron.xpm     
WE ./imgs/shavo.xpm
EA ./imgs/john.xpm   

S ./imgs/sprite.xpm
F 0,0,0
C 255,255,255



1111111111111111111111111111111
100000000000000000000001
100000000000000000000001
100000000000000000000001
100000111110000202020001
100000100010000000000001
100000100010000200020001
100000100010000000000001
100000110110000000000001
100000000000001110000001
100000000000001010000001
100000000000001110000001
100000011111111111111111
100000000000000000000001
100000011111111111111111
100000000000000000000001
111111111000000000000001
110100001000000002000001
110000201000000000000001
110100001000000000000001
11011111100000000N000001
110000000000000000000001
111111111000000000000001
111111111111111111111111